第一章	课程介绍
第二章	String,StringBuffer, StringBuilder的区别
第三章	Vector，ArrayList，LinkedList的区别
第四章	HashMap内部实现原理
第五章	HashTask，HashMap，TreeMap的区别
第六章	Java字节流和字符流的区别
第七章	内存泄漏和内存溢出区别
第八章	Syschronized实现原理
第九章	Syschronized与ReentrantLock重入锁的区别
第一十章	equals() 与 hashcode()
第一十一章	java四种对象引用类型区别
第一十二章	JVM虚拟机内存模型
第一十三章	垃圾回收算法
第一十四章	Java常用的几种设计模式
第一十五章	List如何去除重复数据
第一十六章	如何自己手动实现一个线程池
第一十七章	多线程实现生产者/消费者模式
第一十八章	在Java中什么是线程调度
第一十九章	线程与进程的区别
第二十章	在线程中你怎么处理不可捕捉异常
第二十一章	简述IO,BIO,NIO,AIO编程模型
第二十二章	TreeMap实现原理
第二十三章	如何生成全球唯一的序列号
第二十四章	谈谈你对反射的理解
第二十五章	wait(),notify(),notifyAll区别
第二十六章	抽象类与接口的区别
第二十七章	lambda有那些优点
第二十八章	关键字transient作用
第二十九章	JDK和JRE的区别是什么
第三十章	Java到底是不是一种纯面向对象语言
第三十一章	如何判断一个对象已经被回收
第三十二章	两个有序数组合并为一个有序数组
第三十三章	JAVA值类型和引用类型的区别
第三十四章	基本类型转换
第三十五章	递归算法笔试题
第三十六章	condition的作用
第三十七章	Java多线程中join方法的理解
第三十八章	lock接口比synchronized块的优势是什么
第三十九章	java中wait和sleep方法的不同
第四十章	用Java实现阻塞队列
第四十一章	java中volatile关键字理解
第四十二章	Java并发编程-Executor框架集
第四十三章	在Java中CycliBarriar和CountdownLatch有什么区别
第四十四章	Java中Atomic包的原理和分析
第四十五章	Spring好在哪里
第四十六章	动态代理实现日志管理
第四十七章	Spring框架有哪些主要模块
第四十八章	控制反转(IOC)？什么是依赖注入（DI）?
第四十九章	IOC(DI)原理
第五十章	依然注入三种实现方式
第五十一章	Spring Bean作用域之间的区别
第五十二章	Spring有几种配置方式
第五十三章	请解释Spring Bean的生命周期
第五十四章	自动装配模式的区别
第五十五章	如何开启基于注解的自动装配
第五十六章	Spring框架中有哪些不同类型的事件
第五十七章	BeanFactory和ApplicationContext有什么区别
第五十八章	三种较常见的 ApplicationContext 实现方式
第五十九章	如何用基于Java配置的方式配置Spring
第六十章	Spring中注入一个Java Collection
第六十一章	FileSystemResource和ClassPathResource有何区别
第六十二章	Spring 框架中都用到了哪些设计模式
第六十三章	Post，Get区别
第六十四章	Session, Cookie区别
第六十五章	Servlet的生命周期
第六十六章	HTTP 报文包含内容
第六十七章	简述三次握手和四次挥手
第六十八章	postgresql数据库比mysql好在哪里
第六十九章	数据库的左连接，右连接，内连接，外连接
第七十章	数据库四个范式
第七十一章	数据库事务隔离级别
第七十二章	乐观锁和悲观锁
第七十三章	排他锁、共享锁
第七十四章	数据库索引类型及实现方式
第七十五章	索引的优缺点
第七十六章	SQL联合索引 与 单一列的索引区别
第七十七章	索引的实现方式
第七十八章	SQL优化
第七十九章	执行计划explain
第八十章	事务4大特性
第八十一章	数据库where和having的区别，执行顺序、group by 与having如何使用
第八十二章	redis分布式锁的实现
第八十三章	redis5种数据类型
第八十四章	redis两种持久化方式及原理
第八十五章	redis与memcache区别
第八十六章	redis是多线程还是单线程
第八十七章	redis订阅/发布
第八十八章	redis分布式（主从模式）
第八十九章	redis队列
第九十章	Hibernate工作原理
第九十一章	Hibernate的3种对象状态
第九十二章	Hibernate四种查询
第九十三章	Linux基础命令
第九十四章	Linux管道命令
第九十五章	数据库分库分表
第九十六章	Tomcat启动时加载数据到缓存
第九十七章	git如何回退到某个历史版本
第九十八章	SVN和Git优缺点比较
第九十九章	Statement与PreparedStatement的区别?
第一百章	MyBatis如何唯一标识一个SQL语句
第一百一章	Hibernate和MyBatis如何映射一对多关系
第一百二章	ajax原理